##########
#        #
#    ##  #
###  #   #
##       #
##########